==........
=.ffffffo.
..f.=====.
..f.=.x.=.
=.f.=.f.=.
=.f.=.f.=.
.ff...f...
.f=...f...
=ffffff...
==........